10
W.W.-.B.P.B.-.-.-.-
W.W.S.B.P.B.-.-.W.-
-.BS.W.BS.P.B.-.-.-.-
B.P.BS.-.B.-.-.-.-.-
P.B.-.-.-.-.-.-.-.-
B.-.-.-.-.-B.-.-.-
-.-.-.-.-.B.P.B.-.-
-.-.-.-.-.-.B.W.B.-
-.-.-.-.-.-.-.B.P.B
A.-.-.-.-.-.-.-.B.-