10
-.-.-.-.-.-.-.-.B.-
-.-.-.-.-.-.-.B.P.B
-.-.-.-.-.-.B.G.B.-
-.-.-.-.-.B.P.B.-.-
B.-.-.-.-.-.B.-.-.-
P.B.-.-.-.-.-.-.-.-
B.P.BS.-.B.-.-.-.-.-
-.BS.W.BS.P.B.-.-.-.-
G.G.S.B.P.B.-.-.G.-
G.G.-.B.P.B.-.-.-.A