10
G.G.G.G.G.G.G.G.G.G
G.G.W.G.G.G.G.G.G.G
G.G.G.G.G.G.G.W.G.G
G.S.-.-.-.-.G.-.-.G
S.W.S.-.G.-.-.-.-.G
G.S.S.-.A.-.G.-.-.G
G.S.W.S.-.-.-.S.-.G
G.S.S.-.G.-.S.W.S.G
S.W.S.-.-.-.-.S.-.G
G.S.G.G.G.G.G.G.G.G
