10
G.G.GS.G.G.G.G.G.G.G
G.GS.W.GS.G.G.G.GS.G.G
G.G.GS.G.G.G.GS.W.GS.G
G.S.-.-.-.-.G.S.-.G
S.W.S.-.G.-.-.-.-.G
G.S.S.-.A.-.G.-.-.G
G.S.W.S.-.-.-.S.-.G
G.S.S.-.G.-.S.W.S.G
S.W.S.-.-.-.-.S.-.G
G.S.G.G.G.G.G.G.G.G
