10
-.-.B.-.-.-.-.-.-.-
-.B.P.B.-.-.-.-.-.-
-.-.B.-.-.-.-.-.-.-
-.-.-.-.B.-.-.-.-.-
-.-.-.B.P.B.-.-.-.-
-.-.-.-.B.-.B.B.-.-
-.B.-.B.-.B.BP.BP.B.-
B.P.B.P.B.-.B.B.-.-
-.B.-.B.-.-.-.-.-.-
-.-.-.-.-.-.-.-.-.A
