10
G.BS.W.S.G.G.G.G.G.G
B.P.ABS.W.S.-.-.-.-.G
-.B.P.BS.-.-.-.-.-.-
-.-.B.-.-.-.-.-.-.-
-.G.-.-.-.-.G.-.-.G
-.-.-.G.-.G.-.-.-.-
-.G.-.-.-.-.G.-.-.-
-.-.-.G.G.-.-.-.-.-
-.-.G.-.G.-.-.G.-.-
G.-.-.-.-.-.-.-.-.-
