10
-.-.-.-.-.-.-.-.-.-
-.-.-.-.-.-.-.-.-.-
-.-.-.-.S.-.-.-.-.-
-.-.-.S.W.S.-.-.-.-
-.-.S.W.S.W.BS.-.-.-
-.S.W.BS.A.BS.P.B.-.-
-.-.BS.P.B.P.B.-.-.-
-.-.-.B.P.B.-.-.-.-
-.-.-.-.B.-.-.-.-.-
-.-.-.-.-.-.-.-.-.-
